{
    "c2dictionary": true,
    "data": {
        "1": "FAN",
        "2": "BAD",
        "3": "DIE",
        "4": "FRÜH",
        "5": "RUND",
        "6": "ARTZ",
        "7": "FORT",
        "8": "IDEE",
        "9": "GRAU",
        "10": "SIEB",
        "11": "GRAM",
        "12": "ÜBER",
        "13": "BLEI",
        "14": "WEIN",
        "15": "BRIEF",
        "16": "GEIST",
        "17": "BAUCH",
        "18": "NAGEL",
        "19": "LIEBE",
        "20": "AUTOR",
        "21": "STEIN",
        "22": "SPORT",
        "23": "AGENT",
        "24": "LEHRE",
        "25": "BRAND",
        "26": "STAUB",
        "27": "OLIVE",
        "28": "LAGER",
        "29": "LEHRER",
        "30": "FREUDE",
        "31": "ZIRKUS",
        "32": "EICHEN",
        "33": "FLOTTE",
        "34": "FREUND",
        "35": "BETONE",
        "36": "GENIES",
        "37": "TENNIS",
        "38": "PFOTEN",
        "39": "KUNDEN",
        "40": "BERUFE",
        "41": "EVENTS",
        "42": "TUNNEL",
        "43": "WÜRSTE",
        "44": "INSELN",
        "45": "FRAGEN",
        "46": "FLÜSSE",
        "47": "STRAND",
        "48": "SCHERE",
        "49": "KOPIEN",
        "50": "DAUMEN",
        "51": "ZIEGEN",
        "52": "HERREN",
        "53": "STIFTE",
        "54": "SCHATZ",
        "55": "FISCHE",
        "56": "RÖHREN",
        "57": "ZUCKER",
        "58": "ZEMENT",
        "59": "LIEBEN",
        "60": "SPINNE",
        "61": "SCHUHE",
        "62": "BETTEN",
        "63": "REISEN",
        "64": "KAFFEE",
        "65": "BOHRER",
        "66": "WÄLDER",
        "67": "PINSEL",
        "68": "FEIERN",
        "69": "METALL",
        "70": "FARBEN",
        "71": "FINGER",
        "72": "JUNGEN",
        "73": "KIRCHE",
        "74": "SCHAFE",
        "75": "ANFANG",
        "76": "WINTER",
        "77": "WOCHEN",
        "78": "BIENEN",
        "79": "SPIELE",
        "80": "HERZEN",
        "81": "TELLER",
        "82": "SIEGER",
        "83": "KUCHEN",
        "84": "FROSCH",
        "85": "SCHNEE",
        "86": "HÄUSER",
        "87": "PFERDE",
        "88": "TOMATE",
        "89": "VIDEOS",
        "90": "DELFIN",
        "91": "SCHLAF",
        "92": "BILDER",
        "93": "LÖFFEL",
        "94": "DOKTOR",
        "95": "INHALT",
        "96": "SZENEN",
        "97": "CHANCE",
        "98": "SKIZZE",
        "99": "ESSENZ",
        "100": "DETAIL",
        "101": "HERDEN",
        "102": "GEWINN",
        "103": "JUSTIZ",
        "104": "GIGANT",
        "105": "ETAGEN",
        "106": "GESANG",
        "107": "TALENT",
        "108": "PISTEN",
        "109": "TIEFEN",
        "110": "HELDEN",
        "111": "ÄLTERE",
        "112": "WINKEL",
        "113": "MITTEN",
        "114": "RISIKO",
        "115": "INNERE",
        "116": "SUITEN",
        "117": "LITZEN",
        "118": "SIRENE",
        "119": "GERUCH",
        "120": "SIGNAL",
        "121": "FIRMEN",
        "122": "TINTEN",
        "123": "FIEBER",
        "124": "SCHALS",
        "125": "HÄLFTE",
        "126": "SPIONE",
        "127": "VÖLKER",
        "128": "BRIEFE",
        "129": "TASCHE",
        "130": "HENNEN",
        "131": "SNACKS",
        "132": "MANTEL",
        "133": "REIHEN",
        "134": "STIELE",
        "135": "STEREO",
        "136": "LAMPEN",
        "137": "GRAFEN",
        "138": "PFÄHLE",
        "139": "STUDIE",
        "140": "MACHER",
        "141": "PFEILE",
        "142": "LUNGEN",
        "143": "KNOTEN",
        "144": "GASSEN",
        "145": "SCHWAN",
        "146": "DRÄHTE",
        "147": "WISSEN",
        "148": "FLÖTEN",
        "149": "TASSEN",
        "150": "SPITZE",
        "151": "ARMEEN",
        "152": "LÄUFER",
        "153": "LINIEN",
        "154": "TÜCHER",
        "155": "UNFALL",
        "156": "PREISE",
        "157": "GESETZ",
        "158": "THEMEN",
        "159": "MUSEEN",
        "160": "SHAKES",
        "161": "TREPPE",
        "162": "WESTEN",
        "163": "FEINDE",
        "164": "BLITZE",
        "165": "MONATE",
        "166": "HELFER",
        "167": "AROMEN",
        "168": "LIEDER",
        "169": "KISSEN",
        "170": "WEITEN",
        "171": "BIRKEN",
        "172": "FELDER",
        "173": "MEDIEN",
        "174": "JUGEND",
        "175": "GEWEHR",
        "176": "SEIFEN",
        "177": "KREISE",
        "178": "HALLEN",
        "179": "SCHUTZ",
        "180": "MIETEN",
        "181": "FALLEN",
        "182": "STILLE",
        "183": "TANTEN",
        "184": "DESIGN",
        "185": "FLUIDE",
        "186": "BOMBEN",
        "187": "WRACKS",
        "188": "BESUCH",
        "189": "THRONE",
        "190": "CHILIS",
        "191": "STARTS",
        "192": "KÖNIGE",
        "193": "RUNDEN",
        "194": "GEHWEG",
        "195": "SCHAUM",
        "196": "ZEITEN",
        "197": "REICHE",
        "198": "DENKEN",
        "199": "FEHLER",
        "200": "TORTEN",
        "201": "LIZENZ",
        "202": "LEHREN",
        "203": "KAMINE",
        "204": "TEICHE",
        "205": "WUNDEN",
        "206": "MARINE",
        "207": "RINDEN",
        "208": "KETTEN",
        "209": "ABENDE",
        "210": "STEINE",
        "211": "UNSINN",
        "212": "SEELEN",
        "213": "NEFFEN",
        "214": "RELIEF",
        "215": "VAKUUM",
        "216": "BESITZ",
        "217": "UMFANG",
        "218": "GEBIET",
        "219": "HIRTEN",
        "220": "CHARME",
        "221": "ZEUGEN",
        "222": "FREMDE",
        "223": "STRAFE",
        "224": "MITTEL",
        "225": "MADAME",
        "226": "FÜHRER",
        "227": "ALTÄRE",
        "228": "SILBEN",
        "229": "GESTEN",
        "230": "SCHLAG",
        "231": "WAFFEN",
        "232": "RUINEN",
        "233": "BANDEN",
        "234": "SALONS",
        "235": "LINSEN",
        "236": "KIEFER",
        "237": "RECHTE",
        "238": "FUNKEN",
        "239": "STREIK",
        "240": "KÜHLER",
        "241": "MASSEN",
        "242": "HÖRNER",
        "243": "STRAHL",
        "244": "WETTEN",
        "245": "GNADEN",
        "246": "RIESEN",
        "247": "WANGEN",
        "248": "BECHER",
        "249": "BÜFFEL",
        "250": "ANSATZ",
        "251": "WEIZEN",
        "252": "TOUREN",
        "253": "ROMANE",
        "254": "RAHMEN",
        "255": "WILLEN",
        "256": "MOMENT",
        "257": "FRACHT",
        "258": "WILLST",
        "259": "SEINEN",
        "260": "WIDERE",
        "261": "ERKIES",
        "262": "DEINEN",
        "263": "WEIDEN",
        "264": "HINEIN",
        "265": "NEHMEN",
        "266": "ZUGANG",
        "267": "TWILLS",
        "268": "HECKEN",
        "269": "GINGEN",
        "270": "BRINGT",
        "271": "LÖFFLE",
        "272": "WITWEN",
        "273": "EICHNE",
        "274": "FINISH",
        "275": "MIENEN",
        "276": "KEINEN",
        "277": "WAFFNE",
        "278": "FLUCHT",
        "279": "FINDEN",
        "280": "BEINEN",
        "281": "NEIDEN",
        "282": "WIDDER",
        "283": "NIESEN",
        "284": "MITTAG",
        "285": "DANACH",
        "286": "MEINEN",
        "287": "ENDENS",
        "288": "ECKEND",
        "289": "DIENEN",
        "290": "WEINEN",
        "291": "DÜNUNG",
        "292": "DARAUF",
        "293": "WIEDER",
        "294": "EINSEN",
        "295": "DECKEN",
        "296": "DÜNNES",
        "297": "EIBNEN",
        "298": "BINGEN",
        "299": "EINEND",
        "300": "WENIGE",
        "301": "EINENS",
        "302": "WANNEN",
        "303": "HINKEN",
        "304": "WIEDEN",
        "305": "FEIEND",
        "306": "WIEGEN",
        "307": "WÜRFLE",
        "308": "WERDET",
        "309": "SÜNDEN",
        "310": "NIELLI",
        "311": "SENDEN",
        "312": "MEINEM",
        "313": "EWIGEN",
        "314": "EINIGE",
        "315": "GEWANN",
        "316": "PFUNDE",
        "317": "WÜRFEL",
        "318": "BEGINN",
        "319": "WEGGEH",
        "320": "VORORT",
        "321": "EFENDI",
        "322": "LOBBYS",
        "323": "LILIEN"
    }
}